background1.jpg
0
0
3333333333333333333333333333333333333333
3333333333333333333333333333333333333333
3333333333333333333333333333333333333333
3333333333333333333333333333333333333333
3333333393333333333333333333333333333333
3333333311111333333333333333333333333333
3333333333333333336666633333333333333333
3333333333333333333333333333333333333333
3333333333333333333333333333111133333333
3333333333333333333333333333333333333333
3333333333333333333333333333333333333333
3333333333333333333333333333333333333333
3333333111113333333333333333333333333333
3333333333333333333333333333333333333333
3333333333333333333333333333333333333333
3333333333333333333333333333333333333333
3333333333333333333333333333333333333333
3333333333333333333333333333333333333333
3333333333333333333333333311111113333333
3333333333333333333333333333333333333333
3333333333333333333333333333333333333333
3333333333333333333333333333333333333333
3333433333333333333333333333333333333333
3311111133333333333333333377777333333333
3333333333333333333333333333333333333333
3333333333333333333333333333333333333333
3333333333333333333333333333333333333333
3333333333333333333333333333333333333333
2222222222222222222222222222222222222222
0000000000000000000000000000000000000000
8
120
540
1
400
300
0
3
10
0
2
430
360
0
430
360
3
140
220
1
3
160
220
1
3
180
220
1
3
200
220
1
3
220
220
1